---------------------------------------------------------------------------------------------------------------------------------------------------------------------------------------------------------------------------
---------------------------------------------------------------------------------------------------------------------------------------------------------------------------------------------------------------------------
---------------------------------------------------------------------------------------------------------------------------------------------------------------------------------------------------------------------------
--------------------------------------------------------------------------------@-@----------------------------------------------------------------------------------------------------------------------------------------
---------------------?-----------------------------------------------------------#######---###?----------------------------------------^----------###---#??#---------------------------------------------------------------
-------------------------------------------------------------------------------------------------------------------------------------------------------------------------------------------------------------------------=-
------------------------------------------------------------------------------------------------------------------------------------------------------------------------------------------------------------------------==-
-----------------------------------------------------------*------------------------------------------------------------------------------------------------------------------------------------------------------------==-
----------------?---#^#?#-------------------PP------PP-----------------------#^##----------------------------------#-------##------?--?--?--?---#--------##------=--=-------==--==------------------------------------====-
------------------------------------PP------PP------PP----------------------------------------------------------------------------------------------------------==--==-----===--===----------------##?#-------------======-
------------------------------------PP------PP------PP---------------------------------------------------------------------------------------------------------===--===---====--====-------------------------------=======-
------------------------------PP----PP------PP------PP--------------------------------------------------------------------------------------------------------====--====--====--=====------PP------------------PP-========-
------------------------@-----PP----PP---@--PP---@@-PP---------------------------------------------------------------@@-------------&------------@@----@@@@--=====--=====-====--=======----PP--------------@@--PP=========-
================================================================--===========================================---==============================================================--===========================================